1S11111111
1000011111
1011000001
1010011101
1111011111
1111011111
1000000011
1111011011
1000010011
1F11111111
